NO textures/north.xpm
SO textures/south.xpm
WE textures/west.xpm
EA textures/east.xpm

F 255,255,255
C 0,0,0

1111111111111
1000000000001
1000000000001
1001111101101
1000000000101
100S00000101
1011011110101
1011000010101
1020000010011
1111111111111
