NO ./textures/greystone.png
EA ./textures/colorstone.png
SO ./textures/mossy.png
WE ./textures/redbrick.png

C 100,150,200
F 50,75,100

111111111111111111111111111111111
111111111000000000110000000000001
111111111011000001110000000000001
111111111001000000000000000000001
111111111011000001110000000000001
100000000011000001110111110111111
11110111111111011100000010001
11110111111111011101010010001
11000000110101011100000000001
10000000000000000000000010001
10000000000000001101010010001
11000001110101011111011110N01
11110111111101011111111110001
11111111111111111111111111111
