NO textures/NO.png
EA textures/EA.png
SO textures/SO.png
WE textures/WE.png

C 100,150,200
F 50,75,100

1111111111111
1000000000001
1011111101101
1000000000101
1011111110101
1001000000101
1011011110101
1011000010101
100N000001001
1111111111111
