NO ./textures/greystone.png
EA ./textures/colorstone.png
SO ./textures/mossy.png
WE ./textures/redbrick.png

C 105,105,105
F 121,61,0

        1111111111111111111111111
        1000000000110000000000001
        1011000001110000000000001
        1001000000000000000000001
111111111011000001110000000000001
100010000011000001110111111111111
11110111111111011100000010001
11110111111111011101010010011
11001000110101011100000010001
10000000000000001100000010001
10000000000000001101010010001
11000001110101011111011110N0111
11110111 1110101 111111110001
11111111 1111111 111111111111
